############
#..........#
#.#.#.#.#..#
#..........#
#.#.#.#.#..#
#..........#
############